aa	Afar
ab	Abkhazian
af	Afrikaans
am	Amharic (Ameharic)
ar	Arabic
as	Assamese
ay	Aymara
az	Azerbaijani
ba	Bashkir
be	Byelorussian
bg	Bulgarian
bh	Bihari
bi	Bislama
bn	Bengali;Bangla
bo	Tibetan
br	Breton
ca	Català (Catalan)
co	Corsican
cs	Czech(Ceske)
cy	Welsh
da	Dansk (Danish)
de	Deutsch
dz	Bhutani
el	Greek
en	English
eo	Esperanto
es	Español
et	Estonian
eu	Basque
fa	Persian
fi	Finnish
fj	Fiji
fo	Faroese
fr	Français
fy	Frisian
ga	Irish
gd	Scots Gaelic
gl	Galician
gn	Guarani
gu	Gujarati
ha	Hausa
he	Hebrew
hi	Hindi
hr	Hrvatski (Croatian)
hu	Magyar
ia	Armenian
id	Indonesian
ie	Interlingue
ik	Inupiak
in	Indonesian
is	Islenska(Icelandic)
it	Italiano (Italian)
iu	Inuktitut
iw	Hebrew
ja	Japanese
ji	Yiddish
jw	Javanese
ka	Georgian
kk	Kazakh
kl	Greenlandic
km	Cambodian
kn	Kannada
ko	Korean
ks	Kashmiri
ku	Kurdish
ky	Kirghiz
la	Latin
ln	Lingala
lo	Laothian
lt	Lithuanian
lv	Latvian, Lettish
mg	Malagasy
mi	Maori
mk	Macedonian
ml	Malayalam
mn	Mongolian
mo	Moldavian
mr	Marathi
ms	Malay
mt	Maltese
my	Burmese (Myanmar)
na	Nauru
ne	Nepali
nl	Nederlands
no	Norsk
oc	Occitan
om	(Afan) Oromo
or	Oriya
pa	Punjabi
pl	Polish
ps	Pashto, Pushto
pt	Portugues
qu	Quechua
rm	Rhaeto-Romance
rn	Kirundi
ro	Romanian
ru	Russian
rw	Kinyarwanda
sa	Sanskrit
sd	Sindhi
sg	Sangho
sh	Serbo-Croatian
si	Sinhalese
sk	Slovak
sl	Slovenian
sm	Samoan
sn	Shona
so	Somali
sq	Albanian
sr	Serbian
ss	Siswati
st	Sesotho
su	Sundanese
sv	Svenska
sw	Swahili
ta	Tamil
te	Telugu
tg	Tajik
th	Thai
ti	Tigrinya
tk	Turkmen
tl	Tagalog
tn	Setswana
to	Tonga
tr	Turkish
ts	Tsonga
tt	Tatar
tw	Twi
ug	Uighur
uk	Ukrainian
ur	Urdu
uz	Uzbek
ui	Vietnamese
vo	Volapuk
wo	Wolof
xh	Xhosa
yi	Yiddish
yo	Yoruba
za	Zhuang
zh	Chinese
zu	Zulu